เป็นไงบ้างสบายดีไหม	pos
เป็นไง	pos
สวัสดี	pos
ดี	pos
ดีอยู่	pos
ได้อยู่	pos
ขอบคุณ	pos
สู้เสมอs	pos
ผ่าน	pos
โคตรสนุก	pos
สุดยอด	pos
น่ารัก	pos
ขอบคุณทุก	pos
คงคิดถึง	pos
เก็บเวลาที่ดีให้เราได้จดจำ	pos
ทำข้อสอบให้ได้	pos
สู้	pos
รอยยิ้มในความทรงจำ	pos
ทุกนี้ฉันคิดถึง	pos
ความทรงจำที่ดีเหลือเกิน	pos
รักมาก คิดถึงมาก	pos
ดีใจ	pos
รัก	pos
ห่วง	pos
รักแฟนขี้บ่นจัง	pos
ขอบคุณผู้ใจดี	pos
มิตรภาพดี	pos
ที่รัก	pos
ชอบจัง	pos
ความทรงจำที่ยังสวยงาม	pos
ช่วงเวลาที่รู้จักถึงจะไม่นานแต่คือช่วงที่ดีที่สุด	pos
เปลี่ยนไปรัก รักจนหมดหัวใจ	pos
ดีใจด้วย	pos
ปลอดภัย	pos
ใจเย็น	pos
ดูแลตัวเองด้วย	pos
ขอบคุณมิตรภาพดี เพื่อนที่ดี	pos
โอกาศดี แบบนี้ห้ามพลาด	pos
ขอบคุณ	pos
ง่าย	pos
มองโลกในแง่ดี	pos
ไม่ต้องกลัว	pos
คุณโชคดีกว่าหลายมาก	pos
อดทนต่อไป	pos
ชอบใครก็ชวนมาลองชิมที่คุณทำ	pos
ดูแลตัวเองก็มั่นใจในตัวเองมากขึ้นยิ้มบ่อย	pos
คบนาน สนิทมาก เดี๋ยวก็หาย	pos
ใช้ความรักพลัง	pos
ไม่ขี้งอนไม่น้อยใจใครแม้แต่เพื่อนสนิท	pos
รักตัวเองให้มาก	pos
ไม่ต้องคิดมาก	pos
กำลังใจให้	pos
พรุ่งนี้ต้องดีกว่านี้	pos
ความมิตร  จริงใจ  ทำดีต่อ	pos
ขอบใจมาก	pos
โคตรหล่อ	pos
หยุดยิ้มไม่ได้	pos
อารมณ์ดีเพราะความสุข	pos
ทั้งคู่เหมาะสมมาก	pos
สวยงามมาก	pos
สิ่งที่รู้สึกอยากเห็นมาก	pos
เค้าดี	pos
บรรยากาศอบอุ่นดีมาก	pos
ชอบจัง	pos
ขำตลกจริง	pos
ทำไมน่ารักขนาดนี้	pos
น่ารักมาก อบอุ่น	pos
เดินทางปลอดภัย	pos
อบอุ่นจัง	pos
โคตรฮาหัวเราะอร่อยมาก	pos
ชอบ	pos
ไม่เดือดร้อน	pos
ทำไมน่าร๊าก	pos
นี่ถือเป็นตัวอย่างที่ดี	pos
อวยพร	pos
โชคดี	pos
อย่าได้ไปหวังอะไรลม แล้ง	pos
ความหวังในอนาคต	pos
เขียนได้ดีอ่านเพลินมาก	pos
อย่าปล่อยให้อดีตทำร้ายปัจจุบัน	pos
ขอให้มีความสุข	pos
ความรู้สึกที่ยังเหมือนเดิม	pos
ให้โอกาส	pos
ความสุข	pos
ประโยชน์	pos
รัก	pos
ดีที่สุด	pos
ดีใจมีความสุข	pos
ยังไม่ลืม	pos
ชอบที่เธอแกล้งเราแอบไปยิ้ม	pos
กินของอร่อยมีความสุข	pos
สาธุ	pos
เอาเงินมาบริจาค	pos
ความพยายามอยู่ที่ไหนความสำเร็จอยู่ที่นั้น	pos
สวยรวยเก่ง	pos
น่าอยู่น่าเที่ยว	pos
ข้อดี	pos
สะดวกง่ายเข้าใจเร็วนึกออกง่าย	pos
ไม่เสียใจ	pos
การค้นพบที่น่าตื่นเต้นที่สุด	pos
สบายใจ	pos
ชัดเจน	pos
ยังรอดชีวิต	pos
ถ่ายทำได้ดีมากมุมสวย	pos
จังหวะดีฝีมือเทพน่านับถือ	pos
นี้ฟ้าโปร่งสดใส	pos
เห็นชัดเจน	pos
ทัศนียภาพตื่นตาตื่นใจ	pos
เพลิดเพลินทิวทัศน์	pos
น่าสนดีเหมือนแปลกใหม่น่าท้าลอง	pos
กำลังกลับมา	pos
สุขสันต์วันเกิด	pos
สวัสดีปีใหม่	pos
รัก	pos
วิเศษรอยยิ้มสายตาอบอุ่น	pos
ขอบคุณทุกครั้งที่คอยปลอบฉัน	pos
ชัดเจนแค่เห็นก็ชื่นใจ	pos
ตื่นเต้น	pos
น่ารักที่สุด	pos
เข้าใจตรง	pos
ความทรงจำดี	pos
คิดถึงเหมือนกัน	pos
ดวงดี	pos
ให้โอกาสแก้ตัว	pos
สอบได้	pos
สอบติด	pos
เย้ดีใจด้วย	pos
อดทนไว้	pos
สิ่งดีงามควรรักษา	pos
ความสุขง่ายขึ้นอยู่ที่ใจ	pos
อย่าทิ้งเค้า	pos
สำคัญ	pos
เข้มแข็งเข้าไว้สู้	pos
เห็นด้วย	pos
พูดดี	pos
แคร์ตัวเอง	pos
บินไปให้ถึงฝัน	pos
การทำความดี	pos
ชนะใจด้วยการกระทำ	pos
ความสมบูรณ์แบบ	pos
ความสุขในความคิด	pos
ชื่นชมทำได้ดีมาก	pos
ปังมาก	pos
ชอบช่วยเหลือผู้อื่น	pos
มิตรภาพที่ดีที่สุด	pos
เชื่อมั่นคุณธรรมความดี	pos
หอมน่ากิน	pos
อยากรัก	pos
น่าเรียนจัง	pos
น่ากินน่าอร่อย	pos
ยินดีที่ได้รู้จัก	pos
ใส่บาตรทำบุญ	pos
นี้ที่ดี	pos
สู้ต่อไปสู้ต่อ	pos
แคร์ความรู้สึก	pos
เราโอเค	pos
ผูกพัน	pos
มากอดมา	pos
สนใจ	pos
กำลังใจ	pos
สำคัญสุด	pos
ไม่มีวันไหนไม่คิดถึง	pos
อยากรู้จักจัง	pos
ยกความดีความชอบให้	pos
ช่วงที่ดีที่สุด	pos
ไทยไม่ทิ้งเร่งช่วยเหลือ	pos
เหลือเชื่อมาก	pos
น่าตื่นเต้นและยิ่งใหญ่มาก	pos
เจ๋งไป	pos
ทำทุกอย่างเพื่อปกป้องโลก	pos
อดใจรอไม่ไหว	pos
พอใจในการทำงาน	pos
ภาคภูมิใจ	pos
ศรัทธา	pos
เจริญเติบโตอย่างแข็งแกร่งและสวยงาม	pos
ตอบแทนความหวังดีด้วยการตั้งใจเรียนตั้งใจทำงาน	pos
อยากกลับไปรื้อฟื้นความทรงจำดี	pos
พยายามสุดความสามารถ	pos
จะสู้จนกว่าจะชนะ	pos
สนุกมาก	pos
สนุกสนาน	pos
ขอบคุณที่รัก	pos
อย่ายอมแพ้	pos
ถึงเส้นชัย	pos
ชัยชนะเป็นสิ่งที่คุ้มค่า	pos
ศรัทธาไม่ท้อ	pos
อร่อยที่สุดในโลก	pos
จุดมุ่งหมายอันทะเยอทะยาน	pos
เซอร์ไพรส์	pos
จะไม่ลืมความดีนี้	pos
มาเชียร์เพื่อน	pos
ดีที่สุด	pos
ขอกำลังใจหน่อย	pos
ทุกพูดความจริง	pos
เธอน่ารักจังทำให้ใจเซ	pos
มีข่าวดีมาบอก	pos
เธอเรียบร้อย	pos
ชอบจิตใจดีและขยันมากกว่า	pos
น้ำใจนักกีฬา	pos
ปลอดภัยไว้ก่อนป้องกันไว้	pos
เข้าใจง่ายสะดวกรวดเร็ว	pos
คุณค่าที่คู่ควร	pos
น่ารักอ่ะอยากเดินจับมือไปจนแก่	pos
ว้อนอยากได้	pos
ไม่อดตาย	pos
อยู่ไหนก็รักเหมือนเดิม	pos
ขอกอดหน่อย	pos
ดีเนาะ	pos
ฝันดี	pos
ของอร่อยน่ากิน	pos
เห็นด้วย	pos
ดีต่อใจ	pos
ประหยัด	pos
เชียร์	pos
สดใส	pos
เก่งขึ้นมาก	pos
ขอบคุณที่ติดตาม	pos
ฝีมือพัฒนาเร็วมาก	pos
คำพูดหวานหวาน	pos
หวานน่ากิน	pos
จีบ	pos
คบไหม	pos
แอบรัก	pos
คาดหวัง	pos
เขิน	pos
เพื่อนรัก	pos
ได้ฉันก็ได้	pos
ฝึกฝนจนเก่ง	pos
ชอบความรู้สึกแบบนี้น่ะ	pos
ตั้งเเต่เราคุยเหมือนเราเจอมากขึ้น	pos
ให้นึกถึง	pos
เชื่อมั่นในตนเอง	pos
แรงบันดาลใจให้ใฝ่เรียน	pos
ห่วงเสมอ	pos
ได้ฟังเพลงที่ชอบ	pos
ถึงแพ้ก็จะไม่ยอมถอย	pos
ลาก่อนเดี๋ยวได้เจออีก	pos
สู้ไม่ถอย	pos
จุดหมายไม่ไกลเกินจริง	pos
ตามทัน	pos
มั่นคง	pos
สุขใจขอบคุณเวลา	pos
คุยได้	pos
ความรู้สึกไว้เติมใจ	pos
ขอบใจ	pos
ขายดี	pos
ไว้เจออีกทีในเวลาที่เหมาะสม	pos
รักอยู่เคียงข้างเสมอ	pos
แฮปปี้ความสุขรักเสมอ	pos
ชมว่าสวยขึ้นน่ารักขึ้น	pos
ของน่ารัก	pos
บรรยากาศดีสีสัน	pos
ของโปรด	pos
สวรรค์	pos
เพราะจัง	pos
เพลงไพเราะมาก	pos
พรวิเศษ	pos
เรื่องน่ายินดีใจมาก	pos
กล้าหาญ	pos
การันตี	pos
อนุมัติ	pos
ตัดสินใจได้เด็ดขาด	pos
ตัดสินคดีอย่างยุติธรรม	pos
อนุญาตให้เข้ามาได้	pos
รักษ์โลกรักษ์สิ่งแวดล้อม	pos
ง่ายที่ใครก็ทำได้	pos
ออกกำลังกาย	pos
โอ๋ไม่เสียใจนะ	pos
สร้างสันติภาพ	pos
จงนับถือตัวเองให้มากพอที่จะรู้ว่าคู่ควรสิ่งที่ดีที่สุด	pos
ความท้าทายสิ่งที่ทำให้ชีวิตน่าสนใจแต่การเอาชนะให้ได้สิ่งที่ทำให้ชีวิตความหมาย	pos
อนาคตของขึ้นอยู่สิ่งที่ทำในนี้ไม่ใช่พรุ่งนี้	pos
อย่าเพิ่งยอมแพ้จุดเริ่มต้นนั้นมักจะยากที่สุดเสมอ	pos
สิ่งเดียวที่แน่นอนที่สุดในชีวิตคือความเปลี่ยนแปลง	pos
ความรักความสงบสุข	pos
ความปรารถนาอันร้อนแรงชัยชนะความสำเร็จ	pos
จงแน่วแน่ในการตัดสินใจแต่ให้ยืดหยุ่นการลงมือทำ	pos
ความมั่นใจมาจากการไม่กลัวที่จะทำอะไรผิด	pos
วิธีให้กำลังใจตัวเองที่ดีที่สุดคือการให้กำลังใจอื่น	pos
ก็ได้ค้นพบตัวเอง	pos
สิ่งนี้เกิดขึ้นจากแรงบันดาลใจ	pos
ไตร่ตรองและมองด้านบวกเข้าไว้ 	pos
การเริ่มต้นทำสิ่งเดิมอีกครั้งอย่างชาญฉลาดกว่าเดิม	pos
ฮาขำ	pos
ราตรีสวัสดิ์	pos
กล้าคิดกล้าทำ	pos
ทำความดี	pos
เธอคือทุกอย่างในชีวิต	pos
สดชื่นอากาศดีนี้	pos
อีกไม่นานเกินรอทุกอย่างจะดีขึ้น	pos
สัญญาว่าจะรักเธอคนเดียว	pos
แน่ใจว่าทำได้แน่นอน	pos
สอบผ่าน	pos
รักเสมอ	pos
ของขวัญที่มีค่า	pos
สมหวังทุกประการ	pos
อยากให้เธออยู่เคียงข้างฉันอย่างนี้ทุกคืนอย่างนี้ตลอดไป	pos
พร้อมที่จะเผชิญความจริง	pos
รูปนี้รู้สึกอบอุ่น	pos
อย่างน้อยสนใจ	pos
ยิ้ม	pos
กำลังใจ	pos
ฝัน	pos
แรงใจ	pos
ดวงใจลุกโชนความหวัง	pos
แสงสว่างส่องใจ	pos
ทำจิตให้สงบจะพบทางออก	pos
ความพร้อมอยู่ที่เรา	pos
ลงมือทำอย่างต่อเนื่องเท่านั้นเอง	pos
ต้องเชื่อในศักยาภาพของคุณและความพยายาม	pos
นี่คือสิ่งล้ำค่า	pos
ห่วงใย	pos
สันติภาพสิ่งที่คาดหวัง	pos
หยิบยื่นโอกาส	pos
สานต่อความฝันให้เป็นจริง	pos
ไม่ต้องกังวลใจ	pos
มองโลกในแง่ดี	pos
ทำได้ดีกว่านี้อีก	pos
อยากให้อ่านจะได้เพิ่มกำลังใจให้มากขึ้น	pos
อดทนรอฟ้าใส	pos
เจอที่ใช่และพร้อมฝ่าฟันทุกอย่างไปเรา	pos
พบมุมมองดี	pos
ที่ปรึกษาที่ดี	pos
ผ่านสัมภาษณ์	pos
ปรับปรุง	pos
ที่ยึดเหนี่ยวทางใจ	pos
ทัศนคติที่ดี	pos
แนวทางแก้ปัญหา	pos
มองโลกกว้าง	pos
ศักดิ์ศรี	pos
ไม่เลือนหาย	pos
รวมใจรวมพลัง	pos
คุณภาพดี	pos
ขอให้สมปราถนาที่ตั้งใจไว้ด้วย	pos
ยิ้มรอดีกว่า	pos
ประพฤติดี	pos
เอง	pos
ให้ข้อคิดดี	pos
บุญกุศล	pos
รักเสมือนพี่น้อง	pos
ชนะเลิศ	pos
ได้รางวัลเหรียญทอง	pos
ให้อภัย	pos
รักษาโรค	pos
เข้าใจดี	pos
ทำให้ดีกว่าเดิม	pos
เบิกบาน	pos
เชิดชู	pos
เชิดหน้าชูตา	pos
สามัคคีหนึ่งเดียว	pos
เกียรติยศ	pos
การกุศล	pos
คึกครื้น	pos
เตรียมตัวให้พร้อม	pos
คุ้มค่า	pos
สุภาพเรียบร้อย	pos
ขัดขืนต่อสู้เพื่อป้องกันตัวเอง	pos
ประทับใจ	pos
สาระประโยชน์	pos
กลับตัวกลับใจดี	pos
ได้กำไร	pos
คลี่คลาย	pos
โล่งใจ	pos
รวดเร็วทันใจ	pos
ใจเย็น	pos
ตอกย้ำความทรงจำดี	pos
หวานใจ	pos
เมตตาปราณี	pos
พัฒนาตนเองสม่ำเสมอด้วยความไม่ย่อท้อ	pos
สานฝันให้จริง	pos
อาสา	pos
อยากกอด	pos
เตือนสติ	pos
สันติสุข	pos
สำนึก	pos
เลือกตามใจ	pos
โครตน่ารัก	pos
มหัศจรรย์	pos
สิ่งพิเศษ	pos
วิเศษ	pos
ผ่อนคลาย	pos
ยอมรับ	pos
เจริญรุ่งเรือง	pos
เสียสละ	pos
ไถ่โทษ	pos
ไถ่บาป	pos
อบอวล	pos
สะอาด	pos
เอาใจใส่	pos
ภาวนา	pos
เกียรติคุณ	pos
ด้านบวก	pos
ปลื้มดีใจ	pos
คึกคัก	pos
เจตนาดี	pos
จิตแจ่มใส	pos
เปรี้ยงปร้าง	pos
ฮิต	pos
ที่นิยม	pos
ปลอบใจ	pos
ปรองดอง	pos
ไมตรี	pos
มารยาท	pos
รอบคอบ	pos
บริสุทธิ์ใจ	pos
เคารพนับถือ	pos
วุฒิภาวะ	pos
สุขุม	pos
ฟื้นฟู	pos
ล้ำสมัย	pos
ดีที่สุด	pos
ทันเวลาพอดี	pos
สุจริต	pos
น่าเชื่อถือ	pos
เท่ห์	pos
ไว้วางใจ	pos
เสน่ห์	pos
ทรงพลัง	pos
ฮัก	pos
ทุ่มเท	pos
ภักดี	pos
งอกงาม	pos
คุ้มครอง	pos
พึ่งพา	pos
พึ่งพิง	pos
ยิ้มแย้ง	pos
ประเสริฐ	pos
คลี่คลาย	pos
เที่ยงธรรม	pos
ชดเชย	pos
เอื้อเฟื้อเผื่อแผ่	pos
เยียวยา	pos
คล่องตัว	pos
คล่องแคล่ว	pos
อุทิศ	pos
เอ็นดู	pos
เพียงพอ	pos
เพลิดเพลิน	pos
ถูกใจ	pos
ไลค์	pos
อลังการ	pos
ว้าย	pos
สบายดี	pos
เธอเป็นรอยยิ้มสำหรับเรานะ	pos
ยิ้มเยอะๆนะคนเก่ง	pos
เรามั่นใจว่าเธอทำได้	pos
เชื่อในสัญชาติญาณของตัวเองนะ	pos
เธอเข้มแข็งมากนะ	pos
เธอทำมันได้นะ	pos
เธอทำมันได้ดีมาก	pos
เธอแตกต่างจากคนอื่นนะ	pos
เธอเก่งมากที่สามารถควบคุมตัวเองได้	pos
เธอเป็นเพื่อนที่ดีนะ	pos
เธอใจดีมาก	pos
เธอไม่ต้องกังวลกับคำพูดของคนอื่นนะ	pos
ทุกคนไม่ได้สมบูรณ์แบบ 	pos
เธอบอกเราได้นะถ้าเธอต้องการความช่วยเหลือ	pos
เธอเริ่มโตเป็นผู้ใหญ่แล้วนะ	pos
เราเชื่อมั่นในตัวเธอนะ	pos
เธอมีค่ากับเรามากนะ	pos
เธอกำลังเรียนรู้สิ่งใหม่ๆอยู่นะ	pos
เธอสวย/หล่อที่สุดสำหรับเรานะ	pos
อย่าลืมคิดก่อนที่จะพูดนะ	pos
เธอสำคัญกับเรามากนะ	pos
เธออย่าคิดแบบนั้นเลย	pos
เราช่วยกันแก้ปัญหาได้นะ เราจะอยู่ข้างๆเธอเอง	pos
เราเห็นเธอลงมือทำและเรียนรู้อยู่ทุกวันนะ	pos
เราจะคอยดูเธอเติบโตนะ	pos
เธอทำให้ชีวิตเราดีขึ้นนะ	pos
สิ่งที่เธอคิดมันน่าสนใจมาก	pos
เธอทำให้เรามีมุมมองใหม่ๆนะ	pos
เราตื่นเต้นทุกครั้งที่เธอลงมือทำสิ่งใหม่ๆนะ	pos
ขอบคุณนะ เธอช่วยเหลือเราตลอดเลย	pos
เราพร้อมจะอยู่เคียงข้างเธอเสมอนะ	pos
เรามีความสุขทุกครั้งที่ได้คุยกับเธอนะ	pos
เราพร้อมรับฟังเธอเสมอนะ	pos
ดีใจนะที่ตอนนี้เธออยู่กับเรา	pos
เราฟังเธออยู่นะ	pos
เราภูมิใจในตัวเธอ	pos
วันนี้ฉันมีความสุขมาก	pos
ขอบคุณที่อยู่ข้างๆกันนะ	pos
ชีวิตฉันมีความสุขมาก	pos
ฉันจะต้องทำให้ได้	pos
เรารู้เธอไม่ได้อยากทำแบบนั้นหรอก	pos
ถ้าเชื่อว่าไม่แพ้เราก็จะไม่แพ้	pos
อุปสรรคคือแบบทดสอบของชีวิตนะ	pos
สิ่งร้ายๆจะมาพร้อมกับสิ่งดีๆเสมอ	pos
เชื่อมั่นในความสามารถของคุณนะ	pos
ปัญหาทุกอย่างจะผ่านไปได้ด้วยดี	pos
ความสุขในชีวิตจะขึ้นอยู่กับความคิดของคุณนะ	pos
จงมีความสุขกับสิ่งเล็กๆน้อยๆนะ	pos
เชื่อมั่นในตัวเองไว้นะแล้วจะไม่มีใครสามารถหยุดยั้งเธอได้	pos
ใช้ชีวิตให้เต็มที่เลยนะ	pos
เธอสามารถทำได้ทุกอย่างที่เธอต้องการเลยนะ	pos
ชีวิตคือการเรียนรู้	pos
ใช้ชีวิตตามที่ฝันไว้นะ	pos
เธอเก่งมากที่ก้าวผ่านทุกเรื่องมาได้	pos
จงขอบคุณทุกสิ่งที่เกิดขึ้นกับตัวเธอนะคนเก่ง	pos
ไม่มีใครสมบูรณืแบบหรอกนะ ทุกคนสามารถเรียนรู้สิ่งใหม่ๆได้เสมอ	pos
คิดบวกไว้นะ	pos
พ่อกับแม่รักลูกนะ	pos
หนูเก่งมากเลย	pos
สู้ๆนะพ่อแม่เป็นกำลังใจให้เสมอ	pos
ไม่เป็นไร เรามาพยายามกันใหม่นะ	pos
พ่อกับแม่ภูมิใจในตัวลูกมากนะ	pos
พ่อกับแม่เชื่อมั่นว่าลูกต้องทำได้	pos
ลูกทำได้ดีมาก	pos
พ่อกับแม่รู้ว่าหนูทำดีที่สุดแล้วนะ	pos
เป็นไรไหม	pos
ไม่	neg
ไม่ดี	neg
ทำไรไม่ดีสักอย่าง	neg
ไม่ค่อยดี	neg
ไม่ได้เรื่อง	neg
แย่ไปหมด	neg
น้อยใจ	neg
งอน	neg
ไม่ดีพอ	neg
ไม่รู้เรื่อง	neg
ช่างเลวจริงๆ	neg
อึดอัดไม่รัก	neg
ปวดหัวแท้	neg
ไม่มีเงินโว้ย	neg
ขี้เกียจล้านตัว	neg
แย่ว่ะ	neg
ทำไมวะ	neg
ไม่ชอบ	neg
ร้อนตัวหรอ	neg
ไม่น่ารัก	neg
อำลา	neg
เวลาเหนื่อยนี่บ่นใครบ้าง	neg
เสีย	neg
เสียความรู้สึก	neg
เจ็บเจ็บอีก	neg
อิจฉาจัง	neg
ทุเรศ	neg
ทุเรศสุด	neg
แบล็กลิสต์	neg
เพ้อเจ้อคิดไปเอง มโนไปเอง	neg
ไม่ซาบซึ้ง	neg
ข่มขู่บีบบังคับ	neg
เธอมองข้าม	neg
นี้ไงถึงไม่อยากให้รู้เพราะว่าวุ่นวายเเค่นี้ก็พอเเล้ว	neg
หลอกให้รัก 	neg
เเล้วทิ้งไป	neg
ขี้คร้าน	neg
เมื่อยร่างกายอ่อนเพลีย	neg
ตำหนิ	neg
น้อย	neg
ไม่เคย	neg
หัวร้อน	neg
ยากกว่าหลายเท่า	neg
เพราะผิดหวังเยอะ	neg
เจ็บเยอะ	neg
เสียน้ำตา	neg
มันแย่	neg
เบื่อจริงๆ	neg
เสื่อม	neg
ว่างไม่มีอะไรทำ	neg
ไม่สร้างสรรค์	neg
สนุกบนความทุกข์ความไม่สบายของคนอื่น	neg
กลัวเจ็บ	neg
เจ็บ	neg
ราคาแพงเกินไปไม่คุ้ม	neg
เลิกเถอะ	neg
ชอบขี้งอนและน้อยใจ	neg
มันรู้สึกเหนื่อยจนไม่รู้ว่าระบายออกมายังไง	neg
ฟุ้งซ่าน	neg
หิวขี้เกียจลุกไปกิน	neg
เครียดปวดหัว	neg
ล้มโดนเหยียบซ้ำโดนนินทาสารพัดผิดไปหมด	neg
เหี้ย	neg
อันตรายสุด	neg
อันตรายกว่าที่คิด	neg
ร้องไห้เสียใจจากการลาจาก	neg
เบื่อละคร	neg
ฆ่าตัวตายจากปัญหาความเครียด	neg
สังเวยชีวิต	neg
น่ากลัวคือสังเวยชีวิต	neg
อีเหี้ย	neg
เหี้ยกว่านั้นคือกูร้องไห้ตาม	neg
ความตาย	neg
ขู่ให้ลบทันที	neg
โบกมืออำลา	neg
เสือกสอบไม่ติด	neg
กูโง่ขนาดนั้นหรอ	neg
ความรู้สึกกูเหี้ย	neg
ผิดเองไม่พร้อม	neg
ประกาศช้า	neg
ไม่อยากลุ้น	neg
หมดอารมณ์	neg
สอบไม่ติด	neg
เหนื่อย	neg
โครตผี	neg
โดดเดี่ยวไม่มีใคร	neg
เหนื่อยจนไม่อยากทำอะไรละ	neg
ไม่มีใครให้กำลังใจ	neg
หยิ่งเกินไป	neg
ฝันสลาย	neg
เหมือนฟ้าผ่ากลางใจ	neg
แพ้	neg
คือสุดยอดแห่งความห่วยแตก	neg
ความกังวล	neg
เจ็บ สุดๆด้วย	neg
หลอกแฟน ด้วยมุขเดิม	neg
ยอมแพ้ ไม่รู้ทำยังไง	neg
ทอดทิ้ง	neg
ทุกอย่างไร้ค่า	neg
หวังอะไรลมๆ แล้งๆ 	neg
น้ำใต้ศอก	neg
ขายขี้หน้า	neg
ไม่เห็นอะไร	neg
ไม่รู้หวังอะไร	neg
กลัวว่ามันไม่มีอนาคต	neg
อันนี้ค่อนข้างแย่อยู่	neg
ทำร้ายร่างกาย	neg
รำคาญ	neg
น่าเสียดาย	neg
ลำบาก	neg
ถึงไม่รัก	neg
ฉันเสียเธอไป	neg
มันยิ่งทำให้เค้าเจ็บปวด	neg
เจ็บแทบตาย	neg
ความหวังสุดท้ายหายไปละ	neg
โคตรทรมาน	neg
ท้อหมดแรง	neg
แพ้ให้ความไม่ชัดเจน	neg
ไม่พอ	neg
จนไม่มีเงินซื้อ	neg
หลอกว่ายังรัก	neg
พลาดหลายๆอย่างที่สำคัญไป	neg
พบการทุจริต	neg
ให้ยากกว่าเดิม	neg
ไม่มีความหมาย	neg
แสดงออกอย่างรุนแรง	neg
ความน่ากลัว	neg
แย่จัง	neg
กูปากหมาชอบด่า	neg
หลอกให้รักแล้วจากไป	neg
ไม่เห็นค่า	neg
ไม่มีใครเห็นค่า	neg
ใสเกินไป	neg
เกินพอเกินไป	neg
ร้องไห้งอแงไม่ปลอบ	neg
กำลังแย่	neg
เจ้าชู้	neg
หน้าแบบเซ็ง	neg
ขัดจังหวะ	neg
ร้องไห้หนัก	neg
หงุดหวิดโว้ย	neg
ข่มขู่บังคับอยู่ยาก	neg
ไม่เต็ม	neg
ไอ้สัส	neg
ปวดหัวหัวระเบิด	neg
ตายห่าไป	neg
บีบคอตาย	neg
เสื่อมพัง	neg
ดวงไม่ดี	neg
ไล่ออก	neg
กลัวจุดจบแบบนี้ั	neg
เลวร้าย	neg
หลอกไปเสียหาย	neg
ลำพังหนาว	neg
ปัญหา	neg
พูดให้ร้าย	neg
ทำชั่ว	neg
คำตอแหล	neg
สงสาร	neg
โหยหา	neg
ดราม่าเยอะ	neg
โครตกาก	neg
ทำงานบกพร่องจนทำให้เดือดร้อน	neg
เศร้าเสียใจ	neg
ท้อแท้หมดกำลัง	neg
ง่วง	neg
อ่อนแอไร้ค่าไร้ความหมาย	neg
รบกวน	neg
เย็นชาไม่สนใคร	neg
ความทุกข์ยากลำบาก	neg
ล้อเล่นกับความรู้สึก	neg
เสียชีวิตสลดเจ็บสาหัส	neg
หลอก	neg
จมน้ำตายต่อหน้า	neg
ขี้กลัวโดนผีหลอก	neg
แย่ลงไปหมด	neg
หมดศรัทธา	neg
ลอบสังหาร	neg
เขย่าขวัญน่ากลัว	neg
ฉันตื่นสายพลาดไปไม่ทันรถ	neg
พลาดไป	neg
ยอมแพ้	neg
ดราม่าหนัก	neg
เรียกร้องให้แบน	neg
วายร้าย	neg
นินทา	neg
ไม่สบาย	neg
ไม่ใส	neg
ขี้ลืม	neg
ลืม	neg
ไม่แข็งพอ	neg
เกลียดหน้ามึงอ่ะ	neg
ไม่มีใครจดจำ	neg
งานท่วมหัวทำตัวเหมือนว่าง	neg
แปลกหน้าไม่มีใครรู้จัก	neg
โดนเทมันทำให้พัง	neg
น้อย	neg
อย่าให้พูดกวน	neg
ยาโคตรขมไม่อร่อยรสชาติแย่	neg
ตอบยากจังว่ะตายหรือไง	neg
ผีเหี้ยไรเเม่งกูหมั่นใส้	neg
ประกาศผิด	neg
เจอแบบนี้เสียความรู้สึก	neg
งานระดับนี้ผิดพลาดได้ไง	neg
โหด	neg
ลามก	neg
ขยะแขยง	neg
เสือก	neg
อิจฉาสิ	neg
มันนินทา	neg
อยู่เมืองดัดจริตเนี่ยมันอยู่ยากจริงเนอะ	neg
แพ้แล้ว	neg
โดนแทงตาย	neg
ตายในหลุม	neg
เถื่อน	neg
พูดไม่รู้เรื่อง	neg
อดอยากไม่มีเงิน	neg
อดตาย	neg
สุดท้ายโดนหลอก	neg
เศรษฐกิจตกต่ำตกงาน	neg
หิวข้าว	neg
โกรธ	neg
สยองเกินบรรยาย	neg
ไฟไหม้ป่า	neg
เข้าใจผิด	neg
ไม่กล้า	neg
ทิ้ง	neg
เสียไปง่าย	neg
อารมณ์เสีย	neg
เลิก	neg
เศร้า	neg
ทำเหี้ยไรผิด	neg
ฉิบหาย	neg
ประชด	neg
ขอเถียงขาดดิ้น	neg
เห็นร้องไห้	neg
หดหู่	neg
เจ็บคอไอไข้หวัด	neg
เห็นแก่ตัว	neg
อย่าคาดหวัง	neg
หลงทาง	neg
ป่วยไม่สบาย	neg
โดนทิ้ง	neg
ทุบตีไล่ออก	neg
หมดความอดทน	neg
เกรียน	neg
ผิดหวัง	neg
เพ้อเจ้อ	neg
บาป	neg
สังหาร	neg
กลัวเสียมันไป	neg
ถ้ามันเสียไปกู้กลับมาคือไม่เหมือนเดิม	neg
หมดละมันพังไปหมดละมันไม่เหลืออะไรอีก	neg
เกลียด	neg
คิดน้อย	neg
ลาก่อน	neg
ทำตัวไร้ค่า	neg
ทะเลาะ	neg
หลอกลวง	neg
งง	neg
อวดเก่ง	neg
อยู่ดีไม่ว่าดี	neg
ตามไม่ทัน	neg
ความเสี่ยง	neg
น่าสงสาร	neg
ลาออกจากงาน	neg
เหนื่อยและเพลีย	neg
ถีบตกบันได	neg
ขายไม่ออก	neg
อกหักเพราะบอกเลิก	neg
พังยับเยิน	neg
ฉันผิดเอง	neg
ตกนรกทั้ง	neg
แสบท้อง	neg
แสบแก้วหู	neg
ไม่เพราะ	neg
เสียเวลา	neg
มองโลกแง่ร้าย	neg
ร้ายกาจ	neg
หลบหนีความผิด	neg
กดดัน	neg
กดขี่เรียกค่าไถ่	neg
กระวนกระวาย	neg
ก่อกวน	neg
ก่อกรรมทำเข็ญ	neg
ยัดเยียดข้อกล่าวหา	neg
แพ้พนัน	neg
หมกมุ่นในเรื่องเพศเกินไป	neg
ไม่	neg
ปากทำเป็นพูดแต่ไม่รู้เรื่องอะไร	neg
เดินลำพัง	neg
หยุดเล่น	neg
ทำลาย	neg
ทำล้มเหลว	neg
ไม่เหมาะสม	neg
ไม่โปรด	neg
แอบอ้างหลอกลวง	neg
ระยำ	neg
ชิบหาย	neg
สาส	neg
ป่าเถื่อน	neg
สอบตก	neg
เบื่อโรคอ้วน	neg
ล้มตกบันได	neg
แทบขาด	neg
รู้ตัวว่าไม่เหมือนใคร	neg
ปิดกั้น	neg
ท้อ	neg
ห่วย	neg
ไม่ตอบรับกลับ	neg
หมดอายุ	neg
เข่าอ่อน	neg
โดนเหยียด	neg
กังวล	neg
มองโลกในแง่ร้าย	neg
โกรธง่ายฉุนเฉียวบ่อย	neg
อ่อนเพลียง่าย	neg
ว้าวุ่น	neg
คิดไม่ตก	neg
อ้วกไม่สบาย	neg
รู้สึกแย่จัง	neg
ซ้ำรัก	neg
สละสิทธิ์	neg
ตกสัมภาษณ์	neg
บ่น	neg
ไว้อาลัย	neg
พรากจากไป	neg
งี่เง่า	neg
ประชดประชัน	neg
ข่มจุดด้อย	neg
เลอะเทอะ	neg
ย้อนแย้ง	neg
ละเมิดทำร้ายอื่น	neg
เลื่อนหาย	neg
เหยียด	neg
ไม่ระวังจึงเกิดอุบัติเหตุ	neg
แทงใจดำ	neg
มั่วแม่ง	neg
เซ็งเบื่อ	neg
ลีลาน่ารำคาญจริง	neg
เกียจคร้าน	neg
ทำงานแสนเข็ญ	neg
เลือดไหล	neg
รับความเสียหาย	neg
โกง	neg
เสียวตกบันได	neg
โดนแบน	neg
วิบัติ	neg
อาบัติ	neg
ล่วงละเมิด	neg
ไร้สาระ	neg
บรรลัย	neg
หล่นหาย	neg
มลทิน	neg
มลพิษ	neg
ยาพิษ	neg
เซ็ง	neg
พูดจาหมาไม่แดก	neg
ซกมก	neg
อัปมงคล	neg
อัปยศ	neg
ล้อเลียน	neg
ขัดข้อง	neg
ปัญหา	neg
หนี้สิน	neg
เหินห่าง	neg
อู้งาน	neg
ขัดขืน	neg
ข่มขืน	neg
กระทืบ	neg
กระทำชำเรา	neg
กระทำอนาจาร	neg
แก่งแย่งชิง	neg
ข่มขวัญ	neg
ขัดขวาง	neg
ขี้โม้	neg
คดโกง	neg
คลื่นไส้	neg
คลาดเคลื่อน	neg
คว่ำบาตร	neg
คัดค้าน	neg
เคร่งเครียด	neg
ถูก	neg
หมิ่น	neg
ทุบตี	neg
ดำ	neg
เนรคุณ	neg
แตกสลาย	neg
ขาดดุล	neg
ขาดทุน	neg
หลบหน้า	neg
เดือดเนื้อร้อนใจ	neg
โง่ปัญญาอ่อน	neg
ความเหลื่อมล้ำ	neg
จากเป็นหรือจากตายสุดท้ายก็จากไป	neg
เหลือความทรงจำรอลืมเลือน	neg
ไม่มีรอยยิ้ม	neg
ตอกย้ำความเจ็บปวด	neg
ไม่เมตตาปราณี	neg
สายเกินไป	neg
พลัดพราก	neg
กักขัง	neg
สยองขวัญ	neg
ไร้สาระ	neg
โกหก	neg
ดันทุรังดื้อดึง	neg
กวนตีน	neg
ไว้อาลัย	neg
ซ้ำ	neg
ตัณหา	neg
ลืมตัว	neg
โง่เขลา	neg
สาบสูญ	neg
จรจัด	neg
งอแง	neg
ขัดผลประโยชน์	neg
ฉิบหาย	neg
สมเพช	neg
เบียดเบียน	neg
ขยะสังคมสัส	neg
ด่าลับหลัง	neg
เสียดสี	neg
มะเร็ง	neg
อคติ	neg
ไม่ทันคิด	neg
แหกตา	neg
ไม่รู้จักโลก	neg
โวยวาย	neg
เฮงซวย	neg
แม่งมั่วซั่วไปหมด	neg
เสียสติด้วยความคลั่ง	neg
อุปสรรค	neg
ขัดสน	neg
กลุ้มอึดอัด	neg
ไม่ไหว	neg
อันตรายถึงตาย	neg
งงงวย	neg
ก้าวร้าว	neg
ยาก	neg
เบลอ	neg
ปล้น	neg
โดนดุ	neg
อุบาท	neg
ครหา	neg
โสโครก	neg
หายนะ	neg
กระวนกระวาย	neg
เวียนหัว	neg
ซ้ำร้าย	neg
ฟุ่มเฟือย	neg
ด้านลบ	neg
หงุดหงิด	neg
ไม่เนียน	neg
ประจาน	neg
ดับอนาถ	neg
เศร้าสลดเสียใจ	neg
ยกเลิก	neg
ถลอก	neg
เจตนาไม่ดี	neg
อ่อนเพลีย	neg
ระงับ	neg
สิ้นเปลือง	neg
วังเวงน่าสยดสยอง	neg
เยาะเย้ย	neg
อิจฉาริษยา	neg
เบียดเสียดยัดเยียด	neg
เกะกะ	neg
อาฆาตมาดร้าย	neg
หมิ่นประมาท	neg
หมิ่น	neg
สาปแช่ง	neg
โจมตี	neg
ผิดเพี้ยน	neg
คงร้องไห้	neg
ไม่เข้า	neg
ระแวง	neg
ย่อยยับ	neg
สกปรก	neg
อัปปรี	neg
เหน็บแนม	neg
ติดคุก	neg
ขาดแคลน	neg
คุกคาม	neg
โกรธเคือง	neg
ล้าหลัง	neg
ยุ่งยาก	neg
ริดรอน	neg
นักเลง	neg
กำพร้า	neg
พาล	neg
บิดเบือน	neg
กลั่นแกล้ง	neg
ขัดแข้งขัดขา	neg
ขัดผลประโยชน์	neg
หกล้ม	neg
ย่อท้อ	neg
เหงา	neg
โรยร่วง	neg
คลุมเครือ	neg
ยาจก	neg
เสแสร้งจอมปลอม	neg
ตอแหล	neg
ช็อค	neg
ล่าช้า	neg
โมโห	neg
เหยียดหยาม	neg
หวั่นไหว	neg
สูญเสีย	neg
ตำหนิ	neg
แตกแยก	neg
ด่างพร้อย	neg
หยาบคาย	neg
พังทลาย	neg
ทรุดโทรม	neg
แตกหัก	neg
กบฏ	neg
ข่มเหง	neg
ยุ่งเหยิง	neg
โลเล	neg
ชิ	neg
ชิชะ	neg
แล้ว	neg
หือ	neg
หน็อยแน่	neg
อูย	neg
โอย	neg
โอ๊ย	neg
แฮก	neg
สัสเสีอก	neg
อีเหี้ย	neg
เจ็บแสบ	neg
ลาก่อน	neg
สู้สู้	neg
เป็นไรมากป่ะ	neg
มึงมันไม่เอาไหน	neg
อย่ามาเถียง	neg
มึงจะทำได้เหรอ	neg
ทำไมคนอื่นเขาทำได้แต่เธอทำไม่ได้	neg
เราผิดหวังในตัวเธอมากนะ	neg
เราไม่เชื่อเธอหรอก	neg
เราไม่ไหวกับเธอแล้วจริงๆ	neg
ทำไมชอบทำตัวให้มีปัญหาอยู่เรื่อยเลย	neg
เรียกร้องความสนใจเหรอ	neg
เธอทำแบบนี้ทำไม 	neg
หยุดร้องไห้เดี๋ยวนี้	neg
เธอจะต้องให้เราบอกเธออีกกี่ครั้ง	neg
เคยเตือนแล้วใช่ไหมทำไมไม่ฟังกันบ้างเลย	neg
หยุดกวนเราสักที	neg
อย่ามาตอแย	neg
เลิกยุ่งกับเราสักที 	neg
เลิกทำตัวน่ารำคาญได้แล้ว	neg
เธอโง่หรืออะไร	neg
เธอไม่เคยรู้เรื่องอะไรเลยเหรอ	neg
อย่ามั่นหน้าให้มาก	neg
กลายเป็นคนแบบนี้ตั้งแต่เมื่อไหร่ 	neg
เราไม่ได้รวยเหมือนเขานี่	neg
เธอไม่มีอะไรดีเลยใช่ไหม	neg
เธอมันไม่ได้เรื่อง	neg
เธอทำไม่ได้หรอก	neg
เรื่องแค่นี้ทำไมทำไม่ได้	neg
เหนื่อยจนไม่อยากทำอะไรแล้ว	neg
ไม่สำนึกอะไรเลยหรือไง	neg
ฉันไม่มีความสามารถในเรื่องนี้เลย	neg
ฉันทำไม่ได้แน่เลย	neg
ทำแบบนี้ไม่น่ารักเลยนะ	neg
ฉันเป็นคนอ่อนแอ	neg
ฉันต้องล้มเหลวแน่ๆ	neg
เธอมันน่าเบื่อที่สุด	neg
ถ้าเธอยังทำตัวแบบนี้ก็ไม่มีใครรักเธอหรอก	neg
เธอทำอะไรก็ผิดพลาดไปหมด	neg
